Please press SPACE to continue.

You have served your six months' sentence for burglary and now you hope to benefit from what you have learned.

Old Jones was a good mate to you. Mind you, Jonesy doesn't realise how much information was given away whilst asleep. Sleep talking is a fairly common occurrence I suppose.

The sly old devil. Pulled off a bank robbery three years ago and saw that the money was never recovered. A grand and a half stashed away where nobody would find it. Nobody except you, that is. Poor old Jones was arrested in the village of Lower Ashley SANS LOOT. The robbery had been from one of the banks in Greater Mudchester, ten miles south.

Please press SPACE to continue.

Lying between the two, of course, is Wychwood. Good old Jonesy, Wychwood.

From what you have heard while the old codger was giving it zeds the money is stashed away in the vicinity of Wychwood Manor.

It could still take some finding of course but you know how old Jonesy thinks, don't you?

When you get to Wychwood your instinct should help you. Six months isn't long enough to dull your senses.

This car was easy enough to nick, huh? Don't care much for the colour but that is the least of your concerns.

Can't be much further now. 

Please press SPACE to continue.

Ah, there's the turning for Wychwood. I'll park the car here. The road is quite off the beaten track and anyway nobody should be snooping around at this time of the morning.

Not even seven yet. Right, here goes...

Wychwood
Translated from Version E4 to Inform 7 by ferkung
Originally by Geoffrey Hans Larsen
Release 1 / Serial number 221222 / Inform 7 v10.1.2 / D

Parked
The car is parked in a country lane which leads East. The sound of singing birds fills the crisp fresh air of an early Autumn morning.

>e
T-Junction
A splashing sound comes from the East. The T-Junction leads North, East & West.

>e
Outside the House
A lovely house overlooks a small pond of lilies. The lane turns away to the North and East. The junction is West.

>n
Northern Pond
Here a notice stands beside the pond. The lane bends East/West around the water.

>exam pond
I can see a steel piping here.

A distant church clock strikes 7.

>get pipi
Taken.

>w
Outside the House
A lovely house overlooks a small pond of lilies. The lane turns away to the North and East. The junction is West.

>w
T-Junction
A splashing sound comes from the East. The T-Junction leads North, East & West.

>n
Mansion Lane
The lane leads North towards a large rambling mansion in the distance.

>n
Narrow Dirt Roads
I am South of the mansion with narrow dirt roads to either side of me.

>w
Outside the West Cabin
I am outside a portable cabin. A small window looks East.

>open door
I open the cabin door.

>enter cabin
Inside the West Cabin
Inside the cabin is a table and a drawer and a motto hangs on the wall.

>exam drawer
I can also see:

A paper-clip 
A note

>get clip
Taken.

>leave
Outside the West Cabin
I am outside a portable cabin. A small window looks East.

I can also see: 
An open door

>e
Narrow Dirt Roads
I am South of the mansion with narrow dirt roads to either side of me.

>n
Front Lawn
I am inside the gateway of the mansion. The path leads North and a side path curves west.

>w
West of the Front Lawn
I am West of the front lawn. A heavy stone slab lies on the ground.

>push slab
A bat swoops out past me.

I can also see: 
Steps Down

>d
Bottom of the Stone Steps
I am at the bottom of the stone steps beside a heavy, wooden door

>open door
I can also see:
A tunnel

>go tunnel
Tunnel Entrance
In the dim light, I can barely see that a small low tunnel leads North away from the door.

>n
Inside the Tunnel
Stone steps lead Down. The stone walls are dripping water and a dank smell hangs heavy in the air.

>d
Deep Steps
I am on stone steps above a trap door.

>lift trap
I can also see:
Steps Down

>d
Circular Room
Everything's dark, I can't see.

>feel
(the cord)
I feel a cord in front of me.

>pull cord
CLICK!

I am in a small, circular room. Beside the bed and cupboard is a circle of strange symbols marked on the floor. Beneath a shelf is a small table.

>exam bed
I can also see:
A lighter

>get lighter
Taken.

>exam table
I can also see:
A fat cigar 
An old newspaper

>get news
Taken.

>l
Circular Room
I am in a small, circular room. Beside the bed and cupboard is a circle of strange symbols marked on the floor. Beneath a shelf is a small table.

On the table is a fat cigar.

>u
CLICK!

Deep Steps
I am on stone steps above a trap door.

>u
Inside the Tunnel
Stone steps lead Down. The stone walls are dripping water and a dank smell hangs heavy in the air.

>s
Tunnel Entrance
In the dim light, I can barely see that a small low tunnel leads North away from the door.

>go door
Bottom of the Stone Steps
I am at the bottom of the stone steps beside a heavy, wooden door

I can also see:
A tunnel

>u
West of the Front Lawn
I am West of the front lawn. A heavy stone slab lies on the ground.

I can also see: 
Steps Down

>e
Front Lawn
I am inside the gateway of the mansion. The path leads North and a side path curves west.

>n
Garden Pathway.
The ornate garden pathway neatly divides the front lawn. Paw prints cross the path from one side to the other. A garden swing creaks in the morning breeze.

>n
Outside the Front Door
I am outside the front door. Above the keyhole is a notice and a carved figure head forms the door-knocker. The base of the door has clawed scratches across it and the morning breeze sighs wistfully as it blows through a small gap below the door.

>exam keyhole
The key seems to have been left in the other side of the door.

>slide news
OK.

>bend clip
OK.

>use wire
The key falls from the other side of the door.

>pull news
I can also see: 
And old newspaper
A brass key

>get bras
OK.

>get brass
I already have that.

>open door
It seems to be locked.

>unlock door
(with the brass key)
I can also see: 
An open door

>go door
Front Hallway
I am in the front hallway at the bottom of a staircase. The dining room is East and the lounge is West. A painting of Stonehenge hangs on the wall and the front door is South.

>climb stairs
Top of the Stairs
I am at the top of the stairs with exits North, East, West, and Down.

>u
(first opening the ceiling panel)
Can't reach!

>n
Bathroom
The bathroom window overlooks a village to the North and a full-length mirror hangs on one wall.

I can see a chair here.

>get chair
Taken.

>s
I walk through the door then hear a scuttling sound above me.

Top of the Stairs
I am at the top of the stairs with exits North, East, West, and Down.

>drop chair
Dropped.

>look up
I can also see:
A panel in the ceiling

>stand chair
I can also see:
A panel in the ceiling
I'm on a chair

>l
Top of the Stairs
I am at the top of the stairs with exits North, East, West, and Down.

I can also see:
A panel in the ceiling
I'm on a chair

>get down
But I am not in anything at the moment.

>d
Top of the Stairs
I am at the top of the stairs with exits North, East, West, and Down.

I can also see:
A panel in the ceiling

I can see a chair here.

>u
(first opening the ceiling panel)
Can't reach!

>enter panel
I can't go in that direction.

A distant church clock strikes 8.

>stand chair
I can also see:
A panel in the ceiling
I'm on a chair

>enter panel
The Loft
I am within the loft. One corner appears dark and foreboding. The stairs are Down below me.

I can see a bucket here.

* * *

>drop chair
Dropped.

>stand chair
I can also see:
I'm on a chair

>open panel
I can also see:
An open panel
I'm on a chair

>go panel
The Loft
I am within the loft. One corner appears dark and foreboding. The stairs are Down below me.

I can see a bucket here.

>get buck
Taken.

>get bucket
I already have that.

>d
The Loft
I am within the loft. One corner appears dark and foreboding. The stairs are Down below me.

>w
I can't go that way.

A distant church clock strikes 8.

>d
Top of the Stairs
I am at the top of the stairs with exits North, East, West, and Down.

I can see a chair here.

>w
West Bedroom.
I am in the West bedroom. The floor is covered by a thick-pile carpet and a chest of drawers and double bed make up the main items of furniture.

>exam bed
I can also see:
A credit card

>get credit
Taken.

>e
Top of the Stairs
I am at the top of the stairs with exits North, East, West, and Down.

I can see a chair here.

>d
Front Hallway
I am in the front hallway at the bottom of a staircase. The dining room is East and the lounge is West. A painting of Stonehenge hangs on the wall and the front door is South.

>s
The door slams behind me.

Outside the Front Door
I am outside the front door. Above the keyhole is a notice and a carved figure head forms the door-knocker. The base of the door has clawed scratches across it and the morning breeze sighs wistfully as it blows through a small gap below the door.

I can see an old newspaper here.

>s
Garden Pathway.
The ornate garden pathway neatly divides the front lawn. Paw prints cross the path from one side to the other. A garden swing creaks in the morning breeze.

>s
Front Lawn
I am inside the gateway of the mansion. The path leads North and a side path curves west.

>s
Narrow Dirt Roads
I am South of the mansion with narrow dirt roads to either side of me.

>e
Outside the East Cabin
I am outside a windowless portable cabin. Footprints are visible in the dry, dusty earth.

>use card
The card allows access to the cabin.

Outside the East Cabin
I am outside a windowless portable cabin. Footprints are visible in the dry, dusty earth.

I can also see: 
An open door

>enter cabin
Inside the East Cabin
Inside the cabin is a large crate marked "FX" There is a wall mirror beside which stands a mannequin.

I can see a clapperboard here.

>i
I am carrying:
  a credit card
  a bucket
  a brass key
  a lighter
  a short wire
  a steel piping

* * *

>enter cabin
Inside the East Cabin
Inside the cabin is a large crate marked "FX" There is a wall mirror beside which stands a mannequin.

I can see a clapperboard here.

>l
Inside the East Cabin
Inside the cabin is a large crate marked "FX" There is a wall mirror beside which stands a mannequin.

I can see a clapperboard here.

>exam crate
I can also see:
A squib

>get squib
Taken.

>leave
Outside the East Cabin
I am outside a windowless portable cabin. Footprints are visible in the dry, dusty earth.

I can also see: 
An open door

>w
Narrow Dirt Roads
I am South of the mansion with narrow dirt roads to either side of me.

>s
Mansion Lane
The lane leads North towards a large rambling mansion in the distance.

>s
T-Junction
A splashing sound comes from the East. The T-Junction leads North, East & West.

>e
Outside the House
A lovely house overlooks a small pond of lilies. The lane turns away to the North and East. The junction is West.

>e
Southern Pond
The pond appears to be deeper here and rising bubbles indicate the presense of pond-life. The house lies west and the lane bends North.

>fill bucket
OK.

>w
Outside the House
A lovely house overlooks a small pond of lilies. The lane turns away to the North and East. The junction is West.

* * *

>n
Narrow Dirt Roads
I am South of the mansion with narrow dirt roads to either side of me.

>n
Front Lawn
I am inside the gateway of the mansion. The path leads North and a side path curves west.

>n
Garden Pathway.
The ornate garden pathway neatly divides the front lawn. Paw prints cross the path from one side to the other. A garden swing creaks in the morning breeze.

>n
Outside the Front Door
I am outside the front door. Above the keyhole is a notice and a carved figure head forms the door-knocker. The base of the door has clawed scratches across it and the morning breeze sighs wistfully as it blows through a small gap below the door.

I can see an old newspaper here.

>open door
It seems to be locked.

>i
I am carrying:
  a squib
  a credit card
  a bucket of water
  a brass key
  a lighter
  a short wire
  a steel piping

>unlock door
(with the brass key)
I can also see: 
An open door

* * *

>go door
Front Hallway
I am in the front hallway at the bottom of a staircase. The dining room is East and the lounge is West. A painting of Stonehenge hangs on the wall and the front door is South.

>e
The Dining Room
I am in the dining room. An ornate chandelier hangs from the ceiling and a brass candelabrum sits on a thick, wooden mantelshelf.

I can see a bowl of fruit here.

>exam cand
The candelabrum feels loose.

>pull cand
I hear a creaking sound...

I can also see:
An opening

>go opening
Secret Room
I am within a small scret room. Several photographs of leading Communists hang on the wall.

I can see a Russian flag, a diary, and a memo pad here.

>get flag
Taken.

>leave
The panel closes up behind me.

The Dining Room
I am in the dining room. An ornate chandelier hangs from the ceiling and a brass candelabrum sits on a thick, wooden mantelshelf.

I can see a bowl of fruit here.

>w
Front Hallway
I am in the front hallway at the bottom of a staircase. The dining room is East and the lounge is West. A painting of Stonehenge hangs on the wall and the front door is South.

>w
The Lounge
The lounge contains several glass cases displaying mounted fish. Amonst many photgraphs of game fish is a portrait of a man, woman, and child. The smell of fresh paint comes from the North.

I can see a rod and line here.

>get rod
Taken.

>n
Back Room
The recently-decorated back room overlooks an immaculate lawn. Exits are East and South.

>e
Back Hallway
At the back of the hallway, a door leads into the garden. The kitchen is East and the front door is south.

>open door
The door shuts behind me.

Garden
The superb back garden is surrounded by a ten feet high wall.

I can see a fierce dog, a wooden shed, and a pile of grass here.

>light squib
OK.

>throw squib
BOOM!
The dog scurries away through a small hole in the wall.
A stray spark set the grass alight.

I can also see:
Burning grass
A wooden shed
The grass burns fiercely

>empty bucket
I can also see:
A wooden shed

>go shed
Inside the Shed
Neatly stacked inside the shed are several garden utilities.

I can see a step-ladder here.

>get ladder
Taken.

>leave
Garden
The superb back garden is surrounded by a ten feet high wall.

I can see a wooden shed here.

>drop ladder
Dropped.

>climb
(the step-ladder)
Top of Garden Wall
I am standing on the top of the garden wall overlooking a field. The garden is Down below me.

>climb wall
I can't see any such thing.

>jump down
Small Field
I am in a small field with a gate to the North.

>climb gate
Wooden Platform
I am on a wooden platform spanning a ditch between two fields.

>n
Large Field.
In the middle of this field is a tree surrounded by signs of digging. On the tree is a plaque. Exits are East, West, and South.

I can see a plaque here.

>e
East Field
This field has exits North and West.

>n
Northeast Field
A solitary scarecrow hands, with arms outstretched, upon a pole. A tree stands beside a footpath leading north.

>n
Bridlepath
I am on an East/West bridlepath between two fields.

A distant church clock strikes 9.

>n
I can't go that way.

>w
North of the Stream
To the North is a large field and the sound of running water comes form the south.

>e
Bridlepath
I am on an East/West bridlepath between two fields.

>e
Outside the Church
I am outside the village church at the end of a road leading North.

>n
North of the Church
The North/South road passes a field to the West.

>n
End-of-Road
The road meanders Northwards towards Lower Ashley. I should return South.

>n
I can't go that way.

>s
North of the Church
The North/South road passes a field to the West.

>w
North Field
A tractor is stationary in a corner of this field.

>exam tractor
I can also see:

A flask of tea

>get flask
Taken.

>e
North of the Church
The North/South road passes a field to the West.

>s
Outside the Church
I am outside the village church at the end of a road leading North.

>go church
The Church
Inside the church, several villagers are attending matins. The vicar is giving the sermon.

>listen
"Do not be as swift in anger as the raging bull."

>leave
Outside the Church
I am outside the village church at the end of a road leading North.

>w
Bridlepath
I am on an East/West bridlepath between two fields.

>w
North of the Stream
To the North is a large field and the sound of running water comes form the south.

>s
Stream
I am standing beside a clear stream. A man sits alone fishing. Beside him is an empty basket.

I can see a fisherman here.

>give flask
(to the fisherman)
The man smiles gratefully.
Here, try this strong hook if you're after a LARGE fish.

Stream
I am standing beside a clear stream. A man sits alone fishing. Beside him is an empty basket.

I can see a hook here.

>get hook
Taken.

>n
North of the Stream
To the North is a large field and the sound of running water comes form the south.

>n
Oak Field
A tall oak tree stands proudly with its golden-brown leaves rustling softly. Scattered around the base of the tree are fallen leaves, victims of the onslaught of Autumn

I can see a black bull here.

>throw flag
Dropped.

>get flag
Taken.

* * *

>n
Oak Field
A tall oak tree stands proudly with its golden-brown leaves rustling softly. Scattered around the base of the tree are fallen leaves, victims of the onslaught of Autumn

I can see a black bull here.

>wave flag
The bull moves towards me.

>throw flag
Dropped.

* * *

>get flag
Taken.

>s
North of the Stream
To the North is a large field and the sound of running water comes form the south.

The black bull arrives from the north.

The bull moves towards me

>l
North of the Stream
To the North is a large field and the sound of running water comes form the south.

I can see a black bull here.

The bull gets me.

    *** END OF GAME. ***

Would you like to RESTART, RESTORE a saved game, QUIT, or UNDO the last command?

>undo
North of the Stream
[Previous turn undone.]

>undo
Oak Field
[Previous turn undone.]

>undo
Oak Field
[Previous turn undone.]

>l
Oak Field
A tall oak tree stands proudly with its golden-brown leaves rustling softly. Scattered around the base of the tree are fallen leaves, victims of the onslaught of Autumn

I can see a Russian flag and a black bull here.

>get flag
Taken.

>wave flag
The bull moves towards me.

>s
North of the Stream
To the North is a large field and the sound of running water comes form the south.

The black bull arrives from the north.

The bull moves towards me

>throw flag
The bull charges after the flag and disappears.

>l
North of the Stream
To the North is a large field and the sound of running water comes form the south.

>s
Stream
I am standing beside a clear stream. A man sits alone fishing. Beside him is an empty basket.

>n
North of the Stream
To the North is a large field and the sound of running water comes form the south.

>n
Oak Field
A tall oak tree stands proudly with its golden-brown leaves rustling softly. Scattered around the base of the tree are fallen leaves, victims of the onslaught of Autumn

>climb tree
Up the Tree
I am within the tree about ten feet above the ground. There is a fairly large hollow here.

>exam hollow
I see a metal box with a handle on the lid.

>get box
Can't reach!

>use rod
I can't do that.

>use rod-and-line
I can't do that.

>tie hook
(to the rod and line)
OK.

>use rod
Got it... Oh, no... A key falls from the lock back into the hollow.

>get box
(the metal box)
Taken.

>l
Up the Tree
I am within the tree about ten feet above the ground. There is a fairly large hollow here.

>exam tree-metal box
I see nothing special about the metal box.

* * *

>throw flag
The bull charges after the flag and disappears.

>n
Oak Field
A tall oak tree stands proudly with its golden-brown leaves rustling softly. Scattered around the base of the tree are fallen leaves, victims of the onslaught of Autumn

* * *

>exam hollow
I see a metal box with a handle on the lid.

>get box
I can't see any such thing.

>use rod
I can't do that.

>i
I am carrying:
  a hook
  a rod and line
  a credit card
  a bucket of water
  a brass key
  a lighter
  a short wire
  a steel piping

>tie hook
(to the rod and line)
OK.

* * *

>use rod
Got it... Oh, no... A key falls from the lock back into the hollow.

>get box
Taken.

>d
Oak Field
A tall oak tree stands proudly with its golden-brown leaves rustling softly. Scattered around the base of the tree are fallen leaves, victims of the onslaught of Autumn

>clear leaves
I can also see:
A hollow

>exam hollow
I can also see:
A small key
A hollow

>get smal
I can't see any such thing.

>get small
Taken.

>open box
It seems to be locked.

>unlock box
(with the small key)
OK.

>exam box
I can also see:
A hollow
A wad of notes

>exam notes
They are old pound notes, no longer legal tender. Any reward for recovering them would be offset by my theft of the car.

My only consolation is that I have completed this Adventure!

    *** END OF GAME. ***

Would you like to RESTART, RESTORE a saved game, QUIT, or UNDO the last command?

* * *

>light squib
OK.

>z
Time passes.

>undo
Garden
[Previous turn undone.]

>throw squib
BOOM!
The dog scurries away through a small hole in the wall.
A stray spark set the grass alight.

I can also see:
Burning grass
A wooden shed
The grass burns fiercely

>undo
Garden
[Previous turn undone.]

>undo
Garden
[Previous turn undone.]

>l
Garden
The superb back garden is surrounded by a ten feet high wall.

I can see a fierce dog, a wooden shed, and a pile of grass here.

>light squib
OK.

* * *

>z
Time passes.

>z
Time passes.

BOOM!

    *** END OF GAME. ***

Would you like to RESTART, RESTORE a saved game, QUIT, or UNDO the last command?

>undo
Garden
[Previous turn undone.]

* * *

>e
T-Junction
A splashing sound comes from the East. The T-Junction leads North, East & West.

>n
Mansion Lane
The lane leads North towards a large rambling mansion in the distance.

* * *

>n
Narrow Dirt Roads
I am South of the mansion with narrow dirt roads to either side of me.

>w
Outside the West Cabin
I am outside a portable cabin. A small window looks East.

A distant church clock strikes 7.

>open door
I open the cabin door.

>ll
That's not a verb I recognize.

>l
Outside the West Cabin
I am outside a portable cabin. A small window looks East.

I can also see: 
An open door

>enter door
Inside the West Cabin
Inside the cabin is a table and a drawer and a motto hangs on the wall.

>exam drawer
I can also see:

A paper-clip 
A note

* * *

>get clip
Taken.

>bend clip
OK.

>leave
Outside the West Cabin
I am outside a portable cabin. A small window looks East.

I can also see: 
An open door

* * *

>n
Garden Pathway.
The ornate garden pathway neatly divides the front lawn. Paw prints cross the path from one side to the other. A garden swing creaks in the morning breeze.

>s
Front Lawn
I am inside the gateway of the mansion. The path leads North and a side path curves west.

>w
West of the Front Lawn
I am West of the front lawn. A heavy stone slab lies on the ground.

* * *

>d
Circular Room
Everything's dark, I can't see.

>pull cord
CLICK!

I am in a small, circular room. Beside the bed and cupboard is a circle of strange symbols marked on the floor. Beneath a shelf is a small table.

* * *

>exam bed
I can also see:
A lighter

>get light
I can't see any such thing.

>get lighter
Taken.

* * *

>get news
Taken.

>u
CLICK!

Deep Steps
I am on stone steps above a trap door.

* * *

>n
Outside the Front Door
I am outside the front door. Above the keyhole is a notice and a carved figure head forms the door-knocker. The base of the door has clawed scratches across it and the morning breeze sighs wistfully as it blows through a small gap below the door.

>slide news
OK.

>use wire
The key falls from the other side of the door.

* * *

>pull news
I can also see: 
And old newspaper
A brass key

>get brass
OK.

>unlock door
(with the brass key)
I can also see: 
An open door

>enter door
Front Hallway
I am in the front hallway at the bottom of a staircase. The dining room is East and the lounge is West. A painting of Stonehenge hangs on the wall and the front door is South.

>u
Top of the Stairs
I am at the top of the stairs with exits North, East, West, and Down.

>n
Bathroom
The bathroom window overlooks a village to the North and a full-length mirror hangs on one wall.

I can see a chair here.

* * *

>drop chair
Dropped.

>stand on chair
I can also see:
I'm on a chair

>look up
I can also see:
A panel in the ceiling
I'm on a chair

>open panel
I can also see:
An open panel
I'm on a chair

>enter panel
The Loft
I am within the loft. One corner appears dark and foreboding. The stairs are Down below me.

I can see a bucket here.

>get bucket
Taken.

>d
The Loft
I am within the loft. One corner appears dark and foreboding. The stairs are Down below me.

>d
Top of the Stairs
I am at the top of the stairs with exits North, East, West, and Down.

I can see a chair here.

>d
Front Hallway
I am in the front hallway at the bottom of a staircase. The dining room is East and the lounge is West. A painting of Stonehenge hangs on the wall and the front door is South.

* * *

>s
Narrow Dirt Roads
I am South of the mansion with narrow dirt roads to either side of me.

>s
Mansion Lane
The lane leads North towards a large rambling mansion in the distance.

* * *

>e
Outside the House
A lovely house overlooks a small pond of lilies. The lane turns away to the North and East. The junction is West.

>e
Southern Pond
The pond appears to be deeper here and rising bubbles indicate the presense of pond-life. The house lies west and the lane bends North.

A distant church clock strikes 8.

>fill bucket
OK.

>n
Northern Pond
Here a notice stands beside the pond. The lane bends East/West around the water.

>n
I can't go that way.

>w
Outside the House
A lovely house overlooks a small pond of lilies. The lane turns away to the North and East. The junction is West.

* * *

>n
Garden Pathway.
The ornate garden pathway neatly divides the front lawn. Paw prints cross the path from one side to the other. A garden swing creaks in the morning breeze.

I beg your pardon?

>n
Outside the Front Door
I am outside the front door. Above the keyhole is a notice and a carved figure head forms the door-knocker. The base of the door has clawed scratches across it and the morning breeze sighs wistfully as it blows through a small gap below the door.

I can see an old newspaper here.

>unlock door
(with the brass key)
I can also see: 
An open door

>open door
That's already open.

>n
Front Hallway
I am in the front hallway at the bottom of a staircase. The dining room is East and the lounge is West. A painting of Stonehenge hangs on the wall and the front door is South.

>u
Top of the Stairs
I am at the top of the stairs with exits North, East, West, and Down.

I can see a chair here.

>w
West Bedroom.
I am in the West bedroom. The floor is covered by a thick-pile carpet and a chest of drawers and double bed make up the main items of furniture.

* * *

>exam bed
I can also see:
A credit card

>get card
Taken.

>e
Top of the Stairs
I am at the top of the stairs with exits North, East, West, and Down.

I can see a chair here.

* * *

>use card
The card allows access to the cabin.

Outside the East Cabin
I am outside a windowless portable cabin. Footprints are visible in the dry, dusty earth.

I can also see: 
An open door

>enter door
Inside the East Cabin
Inside the cabin is a large crate marked "FX" There is a wall mirror beside which stands a mannequin.

I can see a clapperboard here.

>search crate
I can also see:
A squib

>get squib
Taken.

* * *

>w
Narrow Dirt Roads
I am South of the mansion with narrow dirt roads to either side of me.

>n
Front Lawn
I am inside the gateway of the mansion. The path leads North and a side path curves west.

* * *

>enter door
Front Hallway
I am in the front hallway at the bottom of a staircase. The dining room is East and the lounge is West. A painting of Stonehenge hangs on the wall and the front door is South.

>e
The Dining Room
I am in the dining room. An ornate chandelier hangs from the ceiling and a brass candelabrum sits on a thick, wooden mantelshelf.

I can see a bowl of fruit here.

>pull cand
I hear a creaking sound...

I can also see:
An opening

* * *

>e
Back Hallway
At the back of the hallway, a door leads into the garden. The kitchen is East and the front door is south.

>e
Kitchen
I am in a modern-styled kitchen. The door is West.

>w
Back Hallway
At the back of the hallway, a door leads into the garden. The kitchen is East and the front door is south.

>s
Front Hallway
I am in the front hallway at the bottom of a staircase. The dining room is East and the lounge is West. A painting of Stonehenge hangs on the wall and the front door is South.

>n
Back Hallway
At the back of the hallway, a door leads into the garden. The kitchen is East and the front door is south.

>open door
The door shuts behind me.

Garden
The superb back garden is surrounded by a ten feet high wall.

I can see a fierce dog, a wooden shed, and a pile of grass here.

>exam shed
I see nothing special about the wooden shed.

>exam grass
I see nothing special about the pile of grass.

>exam pile
I see nothing special about the pile of grass.

>empty bucket
Sploosh! Nothing happens.

* * *

>exam pile
I see nothing special about the pile of grass.

>light squib
OK.

* * *

>throw squib
BOOM!
The dog scurries away through a small hole in the wall.
A stray spark set the grass alight.

I can also see:
Burning grass
A wooden shed
The grass burns fiercely

>i
I am carrying:
  a rod and line
  a Russian flag
  a credit card
  a bucket of water
  a brass key
  a lighter
  a short wire

The burning grass sets fire to the shed.

>empty bucket
I can also see:
A woodern shed

* * *

>i
I am carrying:
  a rod and line
  a Russian flag
  a credit card
  a bucket of water
  a brass key
  a lighter
  a short wire

The burning grass sets fire to the shed.

>i
I am carrying:
  a rod and line
  a Russian flag
  a credit card
  a bucket of water
  a brass key
  a lighter
  a short wire

Something that flashed really quickly.

>l
Garden
The superb back garden is surrounded by a ten feet high wall.

>undo
Garden
[Previous turn undone.]

>l
Garden
The superb back garden is surrounded by a ten feet high wall.

I can see a wooden shed and a burning grass here.

The burning grass sets fire to the shed.

>empty bucket
I can also see:
A wooden shed

>l
Garden
The superb back garden is surrounded by a ten feet high wall.

I can see a wooden shed here.

>undo
Garden
[Previous turn undone.]

* * *

>empty bucket
I can also see:
A wooden shed

>enter shed
Inside the Shed
Neatly stacked inside the shed are several garden utilities.

I can see a step-ladder here.

>leave
Garden
The superb back garden is surrounded by a ten feet high wall.

I can see a wooden shed here.

A distant church clock strikes 9.

>enter shed
Inside the Shed
Neatly stacked inside the shed are several garden utilities.

I can see a step-ladder here.

>exit
Garden
The superb back garden is surrounded by a ten feet high wall.

I can see a wooden shed here.

>enter shed
Inside the Shed
Neatly stacked inside the shed are several garden utilities.

I can see a step-ladder here.

>get step
Taken.

>get ladder
I already have that.

>leave
Garden
The superb back garden is surrounded by a ten feet high wall.

I can see a wooden shed here.

* * *

>drop ladder
Dropped.

>climb wall
Top of Garden Wall
I am standing on the top of the garden wall overlooking a field. The garden is Down below me.

>climb
What do you want to climb?

>down
You must name something more substantial.

>l
Top of Garden Wall
I am standing on the top of the garden wall overlooking a field. The garden is Down below me.

>down
Garden
The superb back garden is surrounded by a ten feet high wall.

I can see a step-ladder and a wooden shed here.

>climb
What do you want to climb?

>climb ladder
Top of Garden Wall
I am standing on the top of the garden wall overlooking a field. The garden is Down below me.

>jump
Small Field
I am in a small field with a gate to the North.

>n
(first opening the field gate)
It seems to be locked.

>climb gate
Wooden Platform
I am on a wooden platform spanning a ditch between two fields.

* * *

>n
Large Field.
In the middle of this field is a tree surrounded by signs of digging. On the tree is a plaque. Exits are East, West, and South.

I can see a plaque here.

>x mole
I can't see any such thing.

>w
West Field
In the middle of this field is a tree.

>x tree
I see nothing special about the tree.

>s
Mole-hills
Mole-hills abound within this field. Another field is north.

>x mole
I see nothing special about the mole-hills.

>x molehill
I can't see any such thing.

>x molehills
I see nothing special about the mole-hills.

>n
West Field
In the middle of this field is a tree.

>e
Large Field.
In the middle of this field is a tree surrounded by signs of digging. On the tree is a plaque. Exits are East, West, and South.

I can see a plaque here.

* * *

>climb
What do you want to climb?

>jump
I jump on the spot.

>jump down
I can't do that.

>l
Garden
The superb back garden is surrounded by a ten feet high wall.

I can see a step-ladder and a wooden shed here.

>climb wall
Top of Garden Wall
I am standing on the top of the garden wall overlooking a field. The garden is Down below me.

>jump down
Small Field
I am in a small field with a gate to the North.

>n
(first opening the field gate)
It seems to be locked.

>x gate
It's locked.

>climb gate
Wooden Platform
I am on a wooden platform spanning a ditch between two fields.

>d
I can't go that way.

>n
Large Field.
In the middle of this field is a tree surrounded by signs of digging. On the tree is a plaque. Exits are East, West, and South.

I can see a plaque here.

>read plaque
To all treasure hunters: Farmer brown as asked me to point out that the bejewelled hare is not buried in this field: Kit Williams.

>e
East Field
This field has exits North and West.

* * *

>n
Northeast Field
A solitary scarecrow hands, with arms outstretched, upon a pole. A tree stands beside a footpath leading north.

>exam scar
Looks like Jon Pertwee.

>exam tree
I see nothing special about the tree.

>e
I can't go that way.

>n
Bridlepath
I am on an East/West bridlepath between two fields.

>w
North of the Stream
To the North is a large field and the sound of running water comes form the south.

* * *

>e
Bridlepath
I am on an East/West bridlepath between two fields.

>n
I can't go that way.

>n
I can't go that way.

* * *

>w
North of the Stream
To the North is a large field and the sound of running water comes form the south.

>exam tractor
I can't see any such thing.

>get tea
I can't see any such thing.

>drop tea
I can't see any such thing.

>get flas
I can't see any such thing.

>drop tea
I can't see any such thing.

>get flask
I can't see any such thing.

>e
Bridlepath
I am on an East/West bridlepath between two fields.

* * *

>w
North of the Stream
To the North is a large field and the sound of running water comes form the south.

>n
Oak Field
A tall oak tree stands proudly with its golden-brown leaves rustling softly. Scattered around the base of the tree are fallen leaves, victims of the onslaught of Autumn.

I can see a black bull here.

>wave flag
The bull moves towards me.

* * *

>s
North of the Stream
To the North is a large field and the sound of running water comes form the south.

The black bull arrives from the north.

The bull moves towards me

>s
Stream
I am standing beside a clear stream. A man sits alone fishing. Beside him is an empty basket.

The bull gets me.

    *** END OF GAME. ***

Would you like to RESTART, RESTORE a saved game, QUIT, or UNDO the last command?

* * *

>drop ladder
Dropped.

>l
Garden
The superb back garden is surrounded by a ten feet high wall.

I can see a step-ladder and a wooden shed here.

>climb
What do you want to climb?

>l
Garden
The superb back garden is surrounded by a ten feet high wall.

I can see a step-ladder and a wooden shed here.

>climb ladder
Top of Garden Wall
I am standing on the top of the garden wall overlooking a field. The garden is Down below me.

* * *

>n
Northeast Field
A solitary scarecrow hands, with arms outstretched, upon a pole. A tree stands beside a footpath leading north.

>n
Bridlepath
I am on an East/West bridlepath between two fields.

* * *

>n
North of the Church
The North/South road passes a field to the West.

>w
North Field
A tractor is stationary in a corner of this field.

>search tractor
I can also see:

A flask of tea

>get flask
Taken.

* * *

>s
Outside the Church
I am outside the village church at the end of a road leading North.

>w
Bridlepath
I am on an East/West bridlepath between two fields.

* * *

>w
North of the Stream
To the North is a large field and the sound of running water comes form the south.

>a
That's not a verb I recognize.

>s
Stream
I am standing beside a clear stream. A man sits alone fishing. Beside him is an empty basket.

I can see a fisherman here.

>give flask to fisherman
The man smiles gratefully.
Here, try this strong hook if you're after a LARGE fish.

Stream
I am standing beside a clear stream. A man sits alone fishing. Beside him is an empty basket.

I can see a hook here.

>l
Stream
I am standing beside a clear stream. A man sits alone fishing. Beside him is an empty basket.

I can see a hook here.

>get hook
Taken.

>tie hook
(to the rod and line)
OK.

>tie hook to rod
I can't see any such thing.

>i
I am carrying:
  a rod, line and hook
  a Russian flag
  a credit card
  a bucket of water
  a brass key
  a lighter
  a short wire

>listen
I hear nothing special.

>n
North of the Stream
To the North is a large field and the sound of running water comes form the south.

>e
Bridlepath
I am on an East/West bridlepath between two fields.

* * *

>e
Outside the Church
I am outside the village church at the end of a road leading North.

>go church
The Church
Inside the church, several villagers are attending matins. The vicar is giving the sermon.

* * *

>listen
"Do not be as swift in anger as the raging bull."

>listen
I hear nothing special.

I beg your pardon?

* * *

>listen
I hear nothing special.

>leave
Outside the Church
I am outside the village church at the end of a road leading North.

* * *

>w
North of the Stream
To the North is a large field and the sound of running water comes form the south.

>n
Oak Field
A tall oak tree stands proudly with its golden-brown leaves rustling softly. Scattered around the base of the tree are fallen leaves, victims of the onslaught of Autumn

I can see a black bull here.

>wave
I wave.

>wave flag
The bull moves towards me.

* * *

>s
Stream
I am standing beside a clear stream. A man sits alone fishing. Beside him is an empty basket.

The bull gets me.

    *** END OF GAME. ***

Would you like to RESTART, RESTORE a saved game, QUIT, or UNDO the last command?

>undo
North of the Stream
[Previous turn undone.]

>throw flag
The bull charges after the flag and disappears.

* * *

>n
Oak Field
A tall oak tree stands proudly with its golden-brown leaves rustling softly. Scattered around the base of the tree are fallen leaves, victims of the onslaught of Autumn

>climb
What do you want to climb?

>climb tree
Up the Tree
I am within the tree about ten feet above the ground. There is a fairly large hollow here.

>exam tree
I see nothing special about the tree.

>climb tree
Little is to be achieved by that.

>u
I can't go that way.

>d
Oak Field
A tall oak tree stands proudly with its golden-brown leaves rustling softly. Scattered around the base of the tree are fallen leaves, victims of the onslaught of Autumn

>actions
Actions listing on.

>climb tree
[climbing the oak tree]
[(1) going up]

Up the Tree
I am within the tree about ten feet above the ground. There is a fairly large hollow here.

[(1) going up - succeeded]

[climbing the oak tree - failed]

>actions
Actions listing on.

>actions off
Actions listing off.

>d
Oak Field
A tall oak tree stands proudly with its golden-brown leaves rustling softly. Scattered around the base of the tree are fallen leaves, victims of the onslaught of Autumn

>climb tree
Up the Tree
I am within the tree about ten feet above the ground. There is a fairly large hollow here.

>search hollow
I find nothing of interest.

>exam hollow
I see a metal box with a handle on the lid.

A distant church clock strikes 10.

>use rod
Got it... Oh, no... A key falls from the lock back into the hollow.

>d
Oak Field
A tall oak tree stands proudly with its golden-brown leaves rustling softly. Scattered around the base of the tree are fallen leaves, victims of the onslaught of Autumn

* * *

>clear leaves
I can also see:
A hollow

>l
Oak Field
A tall oak tree stands proudly with its golden-brown leaves rustling softly. Scattered around the base of the tree are fallen leaves, victims of the onslaught of Autumn.

I can also see:
A hollow

>exam hollow
I can also see:
A small key
A hollow

MEE MAW MEE MAW... Someone has called the police!

>exam tree
I see nothing special about the oak tree.

>get key
(the small key)
Taken.

>unlock box
I can't see any such thing.

>unlock metal box
I can't see any such thing.

>i
I am carrying:
  a small key
  a rod, line and hook
  a credit card
  a bucket of water
  a brass key
  a lighter
  a short wire

>u
Up the Tree
I am within the tree about ten feet above the ground. There is a fairly large hollow here.

I can see a metal box (closed) here.

>get box
Taken.

'Hold it!'

Two burly police officers grab hold of my arm.

    *** END OF GAME. ***

Would you like to RESTART, RESTORE a saved game, QUIT, or UNDO the last command?

>undo
Up the Tree
[Previous turn undone.]

>undo
Oak Field
[Previous turn undone.]

>l
Oak Field
A tall oak tree stands proudly with its golden-brown leaves rustling softly. Scattered around the base of the tree are fallen leaves, victims of the onslaught of Autumn.

I can also see:
A hollow

I can see a small key here.

>undl
That's not a verb I recognize.

>undo
Oak Field
[Previous turn undone.]

* * *

>l
Oak Field
A tall oak tree stands proudly with its golden-brown leaves rustling softly. Scattered around the base of the tree are fallen leaves, victims of the onslaught of Autumn.

I can also see:
A hollow

I can see a small key here.

>undo
Oak Field
[Previous turn undone.]

>undop
That's not a verb I recognize.

>undo
Oak Field
[Previous turn undone.]

>undo
"Undo" capacity exhausted. Sorry!

>undo
"Undo" capacity exhausted. Sorry!

>l
Oak Field
A tall oak tree stands proudly with its golden-brown leaves rustling softly. Scattered around the base of the tree are fallen leaves, victims of the onslaught of Autumn.

I can also see:
A hollow

MEE MAW MEE MAW... Someone has called the police!

>u
Up the Tree
I am within the tree about ten feet above the ground. There is a fairly large hollow here.

I can see a metal box (closed) here.

>get box
Taken.

>unlock box
What do you want to unlock the metal box with?

>d
I can't see any such thing.

>unlock box with small key
I can't see any such thing.

>d
Oak Field
A tall oak tree stands proudly with its golden-brown leaves rustling softly. Scattered around the base of the tree are fallen leaves, victims of the onslaught of Autumn.

I can also see:
A hollow

>exam hollow
I can also see:
A small key
A hollow

>get small
Taken.

'Hold it!'

Two burly police officers grab hold of my arm.

    *** END OF GAME. ***

Would you like to RESTART, RESTORE a saved game, QUIT, or UNDO the last command?

* * *

>throw flag
The bull charges after the flag and disappears.

>i
I am carrying:
  a rod, line and hook
  a credit card
  a bucket of water
  a brass key
  a lighter
  a short wire

>climb tree
I can't see any such thing.

>n
Oak Field
A tall oak tree stands proudly with its golden-brown leaves rustling softly. Scattered around the base of the tree are fallen leaves, victims of the onslaught of Autumn

* * *

>get box
I can't see any such thing.

>get metal box
I can't see any such thing.

>l
Up the Tree
I am within the tree about ten feet above the ground. There is a fairly large hollow here.

>exam hollow
I see a metal box with a handle on the lid.

>use rod
Got it... Oh, no... A key falls from the lock back into the hollow.

>l
Up the Tree
I am within the tree about ten feet above the ground. There is a fairly large hollow here.

I can see a metal box (closed) here.

>get box
Taken.

* * *

>d
Oak Field
A tall oak tree stands proudly with its golden-brown leaves rustling softly. Scattered around the base of the tree are fallen leaves, victims of the onslaught of Autumn

>clear leaves
I can also see:
A hollow

A distant church clock strikes 10.

>exam hollow
I can also see:
A small key
A hollow

>get key
(the small key)
Taken.

>unlock box
(with the small key)
OK.

* * *

>enter door
Inside the West Cabin
Inside the cabin is a table and a drawer and a motto hangs on the wall.

>search drawer
I can also see:

A paper-clip 
A note

>l
Inside the West Cabin
Inside the cabin is a table and a drawer and a motto hangs on the wall.

I can also see:

A paper-clip 
A note

>l
Inside the West Cabin
Inside the cabin is a table and a drawer and a motto hangs on the wall.

I can also see:

A paper-clip 
A note

>get clip
Taken.

* * *

Ah, there's the turning for Wychwood. I'll park the car here. The road is quite off the beaten track and anyway nobody should be snooping around at this time of the morning.

Not even seven yet. Right, here goes...

Wychwood
Translated from Version E4 to Inform 7 by ferkung
Originally by Geoffrey Hans Larsen
Release 1 / Serial number 221222 / Inform 7 v10.1.2 / D

Parked
The car is parked in a country lane which leads East. The sound of singing birds fills the crisp fresh air of an early Autumn morning.

>exam car
I've already searched the car. There's nothing inside of any use.

>help
That's not a verb I recognize.

* * *

>exam car
I've already searched the car. There's nothing inside of any use.

>search car
I've already searched the car. There's nothing inside of any use.

>e
T-Junction
A splashing sound comes from the East. The T-Junction leads North, East & West.

* * *

>e
Outside the House
A lovely house overlooks a small pond of lilies. The lane turns away to the North and East. The junction is West.

>e
Southern Pond
The pond appears to be deeper here and rising bubbles indicate the presense of pond-life. The house lies west and the lane bends North.

A distant church clock strikes 7.

>n
Northern Pond
Here a notice stands beside the pond. The lane bends East/West around the water.

>x notice
NO DUMPING

>x pond
I can see a steel piping here.

>get piping
Taken.

>w
Outside the House
A lovely house overlooks a small pond of lilies. The lane turns away to the North and East. The junction is West.

* * *

>w
T-Junction
A splashing sound comes from the East. The T-Junction leads North, East & West.

>w
Parked
The car is parked in a country lane which leads East. The sound of singing birds fills the crisp fresh air of an early Autumn morning.

>n
I can't go that way.

>e
T-Junction
A splashing sound comes from the East. The T-Junction leads North, East & West.

* * *

>enter cabin
Inside the West Cabin
Inside the cabin is a table and a drawer and a motto hangs on the wall.

>read motto
Says: "Look before you leap."

>open drawer
I open the drawer, revealing a paper-clip and a note.

>exam drawer
I can also see:

A paper-clip 
A note

* * *

>get clip
Taken.

>read note
Game originally written with the use of the Quill, rewritten with respect with the use of Inform 7.

>Bend clip
OK.

>leave
Outside the West Cabin
I am outside a portable cabin. A small window looks East.

>e
Narrow Dirt Roads
I am South of the mansion with narrow dirt roads to either side of me.

>e
Outside the East Cabin
I am outside a windowless portable cabin. Footprints are visible in the dry, dusty earth.

>exam footprints
Unusual!

>exam cabin
It's locked.

>n
I can't go that way.

>w
Narrow Dirt Roads
I am South of the mansion with narrow dirt roads to either side of me.

* * *

>open door
I can also see:
A tunnel

>l
Bottom of the Stone Steps
I am at the bottom of the stone steps beside a heavy, wooden door

I can also see:
A tunnel

>Go door
Tunnel Entrance
In the dim light, I can barely see that a small low tunnel leads North away from the door.

>go door
Bottom of the Stone Steps
I am at the bottom of the stone steps beside a heavy, wooden door

I can also see:
A tunnel

>go tunnel
Tunnel Entrance
In the dim light, I can barely see that a small low tunnel leads North away from the door.

>go tunnel
Bottom of the Stone Steps
I am at the bottom of the stone steps beside a heavy, wooden door

I can also see:
A tunnel

>go tunnel
Tunnel Entrance
In the dim light, I can barely see that a small low tunnel leads North away from the door.

>go door
Bottom of the Stone Steps
I am at the bottom of the stone steps beside a heavy, wooden door

I can also see:
A tunnel

>enter tunnel
Tunnel Entrance
In the dim light, I can barely see that a small low tunnel leads North away from the door.

>n
Inside the Tunnel
Stone steps lead Down. The stone walls are dripping water and a dank smell hangs heavy in the air.

* * *

>d
Deep Steps
I am on stone steps above a trap door.

>open door
How?

>open trap
How?

>lift trap
I can also see:
Steps Down

>l
Deep Steps
I am on stone steps above a trap door. 

I can also see:
Steps Down

>d
Circular Room
Everything's dark, I can't see.

>touch
(the cord)
I feel a cord in front of me.

>feel
(the cord)
I feel a cord in front of me.

* * *

>pull cord
CLICK!

I am in a small, circular room. Beside the bed and cupboard is a circle of strange symbols marked on the floor. Beneath a shelf is a small table.

>exam symbols
There are 8 symbols arranged in a circle which obviously have some meaning.

>exam bed
I can also see:
A lighter

* * *

>get lighter
Taken.

>exam lighter
I see nothing special about the lighter.

>x cupboard
I see nothing special about the cupboard.

>exam shelf
I can also see:
A book of the occult

>get book
Taken.

>read book
The book is a treasury of witchcraft and demonology. That's interesting! There is a chapter devoted to the translation of runes and symbols.

>translate symbols
A.P.O.L.L.Y.O.N.

>exam table
I can also see:
A fat cigar 
An old newspaper

A distant church clock strikes 8.

>get news
Taken.

>get cigar
Taken.

>l
Circular Room
I am in a small, circular room. Beside the bed and cupboard is a circle of strange symbols marked on the floor. Beneath a shelf is a small table.

>u
CLICK!

Deep Steps
I am on stone steps above a trap door.

>df
That's not a verb I recognize.

>d
(first opening the trap door)
How?

>u
Inside the Tunnel
Stone steps lead Down. The stone walls are dripping water and a dank smell hangs heavy in the air.

* * *

>u
West of the Front Lawn
I am West of the front lawn. A heavy stone slab lies on the ground.

I can also see: 
Steps Down

>i
I am carrying:
  a fat cigar
  an old newspaper
  a book of the occult
  a lighter
  a short wire
  a steel piping

>e
Front Lawn
I am inside the gateway of the mansion. The path leads North and a side path curves west.

>n
Garden Pathway
The ornate garden pathway neatly divides the front lawn. Paw prints cross the path from one side to the other. A garden swing creaks in the morning breeze.

>n
Outside the Front Door
I am outside the front door. Above the keyhole is a notice and a carved figure head forms the door-knocker. The base of the door has clawed scratches across it and the morning breeze sighs wistfully as it blows through a small gap below the door.

* * *

>pull news
I can also see: 
And old newspaper
A brass key

>get all
brass key: OK.
old newspaper: Taken.

>z
Time passes.

>z
Time passes.

>unlock door
(with the brass key)
I can also see: 
An open door

* * *

>e
The Dining Room
I am in the dining room. An ornate chandelier hangs from the ceiling and a brass candelabrum sits on a thick, wooden mantelshelf.

I can see a bowl of fruit here.

>get fruit
Taken.

>z
Time passes.

>exam cand
The candelabrum feels loose.

* * *

>pull cand
I hear a creaking sound...

I can also see:
An opening

>l
The Dining Room
I am in the dining room. An ornate chandelier hangs from the ceiling and a brass candelabrum sits on a thick, wooden mantelshelf.

I can also see:
An opening

>enter opening
(first opening the opening)

Secret Room
I am within a small scret room. Several photographs of leading Communists hang on the wall.

I can see a Russian flag, a diary, and a memo pad here.

>get flag
Taken.

>exam flag
It shows a hammer and sickle.

>exam diary
Diary contains names and addresses.

>read memo
It says: "Don't miss Larsoft's Adventure Number 4: The Nine Dancers

Or try ferkung's Lost Enterprise."

>leave
The panel closes up behind you.

The Dining Room
I am in the dining room. An ornate chandelier hangs from the ceiling and a brass candelabrum sits on a thick, wooden mantelshelf.

>w
Front Hallway
I am in the front hallway at the bottom of a staircase. The dining room is East and the lounge is West. A painting of Stonehenge hangs on the wall and the front door is South.

>u
Top of the Stairs
I am at the top of the stairs with exits North, East, West, and Down.

>w
West Bedroom.
I am in the West bedroom. The floor is covered by a thick-pile carpet and a chest of drawers and double bed make up the main items of furniture.

>exam drawersz
I can't see any such thing.

>exam drawers
I can't see any such thing.

>get card
I can't see any such thing.

>exam bed
I can also see:
A credit card

* * *

>get card
Taken.

>e
Top of the Stairs
I am at the top of the stairs with exits North, East, West, and Down.

>e
East Bedroom.
I am in the East bedroom. Beneath the window is a large bed and a cabinet stands against one wall.

>exam bed
I see nothing special about the bed.

>exam cabinet
I see nothing special about the cabinet.

>w
Top of the Stairs
I am at the top of the stairs with exits North, East, West, and Down.

>n
Bathroom
The bathroom window overlooks a village to the North and a full-length mirror hangs on one wall.

I can see a chair here.

* * *

>get chair
Taken.

>s
As I walk through the door, I hear a squeaking sound.

Top of the Stairs
I am at the top of the stairs with exits North, East, West, and Down.

>n
Bathroom
The bathroom window overlooks a village to the North and a full-length mirror hangs on one wall.

>exam mirror
Is that something standing behind me?

>s
Top of the Stairs
I am at the top of the stairs with exits North, East, West, and Down.

>drop chair
Dropped.

* * *

>open panel
I can also see:
An open panel
I'm on a chair

>go panel
The Loft
I am within the loft. One corner appears dark and foreboding. The stairs are Down below me.

I can see a bucket here.

A distant church clock strikes 9.

>get bucket
Taken.

* * *

>d
Front Hallway
I am in the front hallway at the bottom of a staircase. The dining room is East and the lounge is West. A painting of Stonehenge hangs on the wall and the front door is South.

>i
I am carrying:
  a bucket
  a credit card
  a Russian flag
  a bowl of fruit
  an old newspaper
  a brass key
  a fat cigar
  a book of the occult
  a lighter
  a short wire
  a steel piping

>s
The door slams behind me.

Outside the Front Door
I am outside the front door. Above the keyhole is a notice and a carved figure head forms the door-knocker. The base of the door has clawed scratches across it and the morning breeze sighs wistfully as it blows through a small gap below the door.

>s
Garden Pathway
The ornate garden pathway neatly divides the front lawn. Paw prints cross the path from one side to the other. A garden swing creaks in the morning breeze.

>s
Front Lawn
I am inside the gateway of the mansion. The path leads North and a side path curves west.

* * *

>e
Outside the East Cabin
I am outside a windowless portable cabin. Footprints are visible in the dry, dusty earth.

>use card
The card grants me access to the cabin.

Outside the East Cabin
I am outside a windowless portable cabin. Footprints are visible in the dry, dusty earth.

I can also see: 
An open door

>enter door
Inside the East Cabin
Inside the cabin is a large crate marked "FX" There is a wall mirror beside which stands a mannequin.

I can see a clapperboard here.

>x clapperboard
I see nothing special about the clapperboard.

>exam crate
I can also see:
A squib

>l
Inside the East Cabin
Inside the cabin is a large crate marked "FX" There is a wall mirror beside which stands a mannequin.

I can see a squib and a clapperboard here.

>get squib
Taken.

>get clapperboard
Taken.

>exam squib
I see nothing special about the squib.

>exam mannequin
I can also see:
A black cloak

>get cloak
Taken.

>exam cloak
It looks spooky!

>wear cloak
I put on the black cloak.

>leave
Outside the East Cabin
I am outside a windowless portable cabin. Footprints are visible in the dry, dusty earth.

I can also see: 
An open door

* * *

>n
Front Lawn
I am inside the gateway of the mansion. The path leads North and a side path curves west.

>n
Garden Pathway
The ornate garden pathway neatly divides the front lawn. Paw prints cross the path from one side to the other. A garden swing creaks in the morning breeze.

* * *

>n
Outside the Front Door
I am outside the front door. Above the keyhole is a notice and a carved figure head forms the door-knocker. The base of the door has clawed scratches across it and the morning breeze sighs wistfully as it blows through a small gap below the door.

>open door
It seems to be locked.

* * *

>n
Front Hallway
I am in the front hallway at the bottom of a staircase. The dining room is East and the lounge is West. A painting of Stonehenge hangs on the wall and the front door is South.

>w
The Lounge
The lounge contains several glass cases displaying mounted fish. Amonst many photgraphs of game fish is a portrait of a man, woman, and child. The smell of fresh paint comes from the North.

I can see a rod and line here.

* * *

>get rod
Taken.

>e
Front Hallway
I am in the front hallway at the bottom of a staircase. The dining room is East and the lounge is West. A painting of Stonehenge hangs on the wall and the front door is South.

>i
I am carrying:
  a rod and line
  a black cloak (being worn)
  a clapperboard
  a squib
  a bucket
  a credit card
  a Russian flag
  a bowl of fruit
  an old newspaper
  a brass key
  a fat cigar
  a book of the occult
  a lighter
  a short wire
  a steel piping

>s
The door slams behind me.

Outside the Front Door
I am outside the front door. Above the keyhole is a notice and a carved figure head forms the door-knocker. The base of the door has clawed scratches across it and the morning breeze sighs wistfully as it blows through a small gap below the door.

* * *

>s
Mansion Lane
The lane leads North towards a large rambling mansion in the distance.

>e
I can't go that way.

>e
I can't go that way.

>s
T-Junction
A splashing sound comes from the East. The T-Junction leads North, East & West.

* * *

>e
Southern Pond
The pond appears to be deeper here and rising bubbles indicate the presense of pond-life. The house lies west and the lane bends North.

>n
Northern Pond
Here a notice stands beside the pond. The lane bends East/West around the water.

>s
Southern Pond
The pond appears to be deeper here and rising bubbles indicate the presense of pond-life. The house lies west and the lane bends North.

>fill bucket
OK.

>fill cloak
I can't do that.

>look up
I see nothing special.

>w
Outside the House
A lovely house overlooks a small pond of lilies. The lane turns away to the North and East. The junction is West.

* * *

>unlock door
(with the brass key)
I can also see: 
An open door

>enter door
Front Hallway
I am in the front hallway at the bottom of a staircase. The dining room is East and the lounge is West. A painting of Stonehenge hangs on the wall and the front door is South.

A distant church clock strikes 10.

>z
Time passes.

>z
Time passes.

MEE MAW MEE MAW... Someone has called the police!

>w
The Lounge
The lounge contains several glass cases displaying mounted fish. Amonst many photgraphs of game fish is a portrait of a man, woman, and child. The smell of fresh paint comes from the North.

>get rod
I already have that.

>z
Time passes.

>z
Time passes.

'Hold it!'

Two burly police officers grab hold of my arm.

    *** END OF GAME. ***

Would you like to RESTART, RESTORE a saved game, QUIT, or UNDO the last command?

* * *

>n
Outside the Front Door
I am outside the front door. Above the keyhole is a notice and a carved figure head forms the door-knocker. The base of the door has clawed scratches across it and the morning breeze sighs wistfully as it blows through a small gap below the door.

>use wire
The key falls from the other side of the door.

>slide paper
OK.

>l
Outside the Front Door
I am outside the front door. Above the keyhole is a notice and a carved figure head forms the door-knocker. The base of the door has clawed scratches across it and the morning breeze sighs wistfully as it blows through a small gap below the door.

I can see a newspaper under the door here.

>pull paper
OK.

>l
Outside the Front Door
I am outside the front door. Above the keyhole is a notice and a carved figure head forms the door-knocker. The base of the door has clawed scratches across it and the morning breeze sighs wistfully as it blows through a small gap below the door.

I can see an old newspaper here.

>get paper
Taken.

>slide paper
OK.

* * *

>l
Outside the Front Door
I am outside the front door. Above the keyhole is a notice and a carved figure head forms the door-knocker. The base of the door has clawed scratches across it and the morning breeze sighs wistfully as it blows through a small gap below the door.

I can see a newspaper under the door here.

>pull news
OK.

>get news
Taken.

>slide news
OK.

>l
Outside the Front Door
I am outside the front door. Above the keyhole is a notice and a carved figure head forms the door-knocker. The base of the door has clawed scratches across it and the morning breeze sighs wistfully as it blows through a small gap below the door.

I can see a newspaper under the door here.

* * *

Ah, there's the turning for Wychwood. I'll park the car here. The road is quite off the beaten track and anyway nobody should be snooping around at this time of the morning.

Not even seven yet. Right, here goes...

Wychwood
Translated from Version E4 to Inform 7 by ferkung
Originally by Geoffrey Hans Larsen
Release 1 / Serial number 221222 / Inform 7 v10.1.2 / D

Parked
The car is parked in a country lane which leads East. The sound of singing birds fills the crisp fresh air of an early Autumn morning.

>help
YOU need help?? What about ME??

Please press SPACE to continue.

To redescribe current location:         type 'L'.

Movement:
        Movement through the game is usually effected by 'N', 'S', 'E', 'W', 'U', and 'D'.

Inventory:
        An inventory of your current possessions can be found by typing 'I'.

Commands:
        Commands are entered in the usual verb-noun or verb format.

To save game position:
        Type 'SAVE'. The current state of play can then be resumed by typing 'LOAD'.

Please press SPACE to continue.

Parked
The car is parked in a country lane which leads East. The sound of singing birds fills the crisp fresh air of an early Autumn morning.

>load
Restore failed.